10 10
0000010000
0000001000
0001000000
0110000000
0000100000
0111000000
0000011000
1111000000
0000111000
0001000000
5 6
0 0